NO ./textures/brick.xpm
SO ./textures/blue.xpm
WE ./textures/grey.xpm
EA ./textures/wood.xpm
DO ./textures/door.xpm

F 125,125,125
C 55,55,55

        1111111111111111111111111
        100E000000110000000000001
        1D11000001110000000000001
        1001000000D00000000000001
111111111011000001110000000000001
10000000001100000111D111111111111
11110111111111011100000010001
1101D111111111011101010010001
11000000110101011100000010001
10000000000000001100000010001
10000000000000001101010010001
1100000111010101111101111000111
11110111 1110101 101111010001
11111111 1111111 111111111111